NO ./map.cub
SO ./map2.cub
WE ./map3.cub
EA ./map4.cub

F 220,1,1
C 225,1,1

1111111111111111111111111
1000000000000000000000001
1000000000000000000000001
1000000000000000000000001
10000000000E0000000000001
1111111111111111111111111

