1111111111111111111111111111111111111111111111111111111111111
1P00C0000100000110100000100101                                     
10K000000K0000E000000010000001                                    
10100110000101000K000000100001                                     
100000C0000K000000001000001001                                     
100000000000000001000000000001                                     
100100000000100000K00000100001                                     
100000000010000100000100000001                                     
101C00001000010000C00000001001                                    
101000000000C00000000000000001                                     
100011000100000001000010000101                                     
10000010000C000000000011000001                                    
100001000000001000011000000001                                     
10K000000010000010010001101001                                     
100100100001000010100000000001                                     
100C00000K000000100010001000C1                                     
111111111111111111111111111111
